electric/ADJ/amod<_X/NOUN/appos_<Y/NOUN/conj	Forward
X/PROPN/nsubj>_castle/PROPN/nsubj>_be/VERB/ROOT_<Y/NOUN/attr	Forward
X/NOUN/pobj_<of/ADP/prep_<Y/PROPN/pobj	Reverse
the/DET/det<_X/NOUN/pobj_<of/ADP/prep_<Y/PROPN/pobj	Reverse
X/PROPN/nsubj>_hotel/PROPN/nsubj>_be/VERB/ROOT_<Y/NOUN/attr	Forward
primary/ADJ/amod<_X/NOUN/conj_<Y/NOUN/conj	Reverse
X/NOUN/nsubj>_device/NOUN/nsubj>_be/VERB/ROOT_<Y/NOUN/attr	Reverse
X/NOUN/pobj_<of/ADP/prep_<Y/NOUN/pobj	Reverse
the/DET/det<_X/NOUN/pobj_<of/ADP/prep_<Y/NOUN/pobj	Reverse
X/NOUN/pobj_<of/ADP/prep_<Y/NOUN/pobj_>in/ADP/prep	Reverse
X/PROPN/compound>_hospital/PROPN/compound>_Y/NOUN/ROOT	Forward
X/NOUN/compound>_telephone/NOUN/compound>_Y/NOUN/ROOT	Reverse
psychiatric/ADJ/amod<_X/NOUN/pobj_<of/ADP/prep_<Y/NOUN/pobj	Reverse
X/NOUN/dobj_<of/ADP/prep_<Y/NOUN/pobj	Reverse
the/DET/det<_X/NOUN/dobj_<of/ADP/prep_<Y/NOUN/pobj	Reverse
X/PROPN/pobj_<Y/NOUN/appos	Forward
the/DET/det<_X/PROPN/pobj_<Y/NOUN/appos	Forward
high/ADJ/amod<_X/NOUN/dobj_<Y/NOUN/conj	Reverse
X/NOUN/nsubj>_catfish/NOUN/nsubj>_be/VERB/ROOT_<Y/NOUN/attr	Forward
X/NOUN/nsubj_<Y/PROPN/conj	Forward
X/NOUN/attr_<with/ADP/prep_<Y/NOUN/pobj	Forward
black/ADJ/amod<_X/NOUN/attr_<with/ADP/prep_<Y/NOUN/pobj	Forward
primary/ADJ/amod<_X/NOUN/dobj_<Y/NOUN/conj	Reverse
X/NOUN/attr_<in/ADP/prep_<series/NOUN/pobj_<Y/PROPN/compound	Reverse
X/NOUN/pobj_<as/ADP/prep_<Y/NOUN/pobj	Reverse
large/ADJ/amod<_X/NOUN/pobj_<as/ADP/prep_<Y/NOUN/pobj	Reverse
X/NOUN/nsubjpass_<of/ADP/prep_<Y/NOUN/pobj	Reverse
the/DET/det<_X/NOUN/nsubjpass_<of/ADP/prep_<Y/NOUN/pobj	Reverse
second/ADJ/amod<_X/NOUN/pobj_<of/ADP/prep_<Y/NOUN/pobj	Reverse
X/NOUN/pobj_<of/ADP/prep_<Y/PROPN/pobj_>in/ADP/prep	Reverse
X/NOUN/nsubj_<of/ADP/prep_<Y/NOUN/pobj	Reverse
the/DET/det<_X/NOUN/nsubj_<of/ADP/prep_<Y/NOUN/pobj	Reverse
X/NOUN/nsubj>_hospital/NOUN/nsubj>_have/VERB/ROOT_<Y/NOUN/dobj	Forward
high/ADJ/amod<_X/NOUN/conj_<Y/NOUN/conj	Reverse
X/PROPN/nsubj>_clinic/PROPN/nsubj>_be/VERB/ROOT_<Y/NOUN/attr	Reverse
the/DET/det<_X/NOUN/attr_<with/ADP/prep_<Y/NOUN/pobj	Forward
X/NOUN/attr_<of/ADP/prep_<Y/NOUN/pobj	Reverse
X/NOUN/pobj_<in/ADP/prep_<Y/PROPN/pobj	Reverse
X/NOUN/nsubjpass_<as/ADP/prep_<Y/NOUN/pobj	Reverse
X/PROPN/pobj_<be/VERB/relcl_<Y/NOUN/attr	Forward
main/ADJ/amod<_X/NOUN/pobj_<of/ADP/prep_<Y/NOUN/pobj	Reverse
X/NOUN/pobj_<of/ADP/prep_<Y/NOUN/pobj_>of/ADP/prep	Reverse
X/NOUN/nsubj>_steam/NOUN/nsubj>_haul/VERB/ROOT_<Y/NOUN/dobj	Reverse
X/NOUN/nsubj>_animal/NOUN/nsubj>_include/VERB/ROOT_<Y/NOUN/dobj	Reverse
X/NOUN/dobj_<piano/NOUN/conj_<Y/NOUN/conj_>and/CCONJ/cc	Forward
X/NOUN/conj_<as/ADP/prep_<Y/NOUN/pobj	Reverse
an/DET/det<_X/NOUN/attr_<Y/NOUN/appos	Forward
X/NOUN/pobj_<of/ADP/prep_<room/NOUN/pobj_<Y/NOUN/compound	Reverse
X/NOUN/appos_<at/ADP/prep_<Y/PROPN/pobj	Reverse
X/PROPN/nsubj>_house/PROPN/nsubj>_be/VERB/ROOT_<Y/NOUN/attr	Reverse
X/NOUN/nsubj>_hotel/NOUN/nsubj>_have/VERB/ROOT_<Y/NOUN/dobj	Forward
some/DET/det<_X/NOUN/pobj_<as/ADP/prep_<Y/NOUN/pobj	Reverse
X/NOUN/pobj_<of/ADP/prep_<Y/PROPN/pobj_>of/ADP/prep	Reverse
X/NOUN/nsubj>_car/NOUN/nsubj>_have/VERB/ROOT_<Y/NOUN/dobj	Forward
X/NOUN/nsubjpass_<in/ADP/prep_<Y/PROPN/pobj	Reverse
X/NOUN/npadvmod_<with/ADP/prep_<Y/NOUN/pobj	Forward
X/NOUN/dobj_<as/ADP/prep_<Y/NOUN/pobj	Reverse
X/NOUN/nsubj>_castle/NOUN/nsubj>_be/VERB/ROOT_<Y/NOUN/attr	Forward
X/PROPN/nsubj_<Y/NOUN/appos	Forward
the/DET/det<_X/PROPN/nsubj_<Y/NOUN/appos	Forward
X/NOUN/compound>_television/NOUN/compound>_Y/NOUN/ROOT	Forward
X/NOUN/appos_<with/ADP/prep_<Y/NOUN/pobj	Forward
X/NOUN/pobj_<at/ADP/prep_<Y/NOUN/pobj	Reverse
the/DET/det<_X/NOUN/pobj_<at/ADP/prep_<Y/NOUN/pobj	Reverse
X/NOUN/nsubj>_axe/NOUN/nsubj>_be/VERB/ROOT_<Y/NOUN/attr	Forward
X/NOUN/oprd_<of/ADP/prep_<Y/NOUN/pobj	Reverse
X/PROPN/pobj_<at/ADP/prep_<Y/PROPN/pobj	Reverse
the/DET/det<_X/PROPN/pobj_<at/ADP/prep_<Y/PROPN/pobj	Reverse
X/NOUN/dobj_<as/ADP/prep_<Y/PROPN/pobj	Reverse
X/NOUN/nsubj>_dog/NOUN/nsubj>_chase/VERB/ROOT_<Y/NOUN/dobj	Reverse
X/NOUN/nsubj>_weapon/NOUN/nsubj>_be/VERB/ROOT_<Y/NOUN/attr	Reverse
X/NOUN/compound>_hotel/NOUN/compound>_Y/NOUN/ROOT	Forward
-pron-/ADJ/poss<_X/NOUN/pobj_<of/ADP/prep_<Y/PROPN/pobj	Reverse
X/NOUN/compound>_district/NOUN/compound>_Y/NOUN/ROOT	Reverse
X/NOUN/nsubj_<to/ADP/prep_<Y/NOUN/pobj	Reverse
the/DET/det<_X/NOUN/nsubj_<to/ADP/prep_<Y/NOUN/pobj	Reverse
X/PROPN/nsubj>_cathedral/PROPN/nsubj>_be/VERB/ROOT_<Y/NOUN/attr	Forward
X/NOUN/pobj_<fire/VERB/acl_<from/ADP/prep_<Y/NOUN/pobj	Reverse
the/DET/det<_X/NOUN/appos_<of/ADP/prep_<Y/PROPN/pobj	Reverse
massachusetts/PROPN/compound<_X/PROPN/pobj_<Y/PROPN/conj	Forward
X/NOUN/compound>_drum/NOUN/compound>_Y/NOUN/ROOT	Reverse
high/ADJ/amod<_X/NOUN/pobj_<of/ADP/prep_<Y/NOUN/pobj	Reverse
X/NOUN/pobj_<include/VERB/prep_<Y/NOUN/pobj	Reverse
medical/PROPN/compound<_X/PROPN/conj_<Y/PROPN/conj	Reverse
X/PROPN/ROOT_<of/ADP/prep_<Y/PROPN/pobj	Forward
X/PROPN/dobj_<Y/NOUN/appos_>of/ADP/prep	Forward
X/NOUN/attr_<have/VERB/relcl_<Y/NOUN/dobj	Forward
the/DET/det<_X/NOUN/attr_<have/VERB/relcl_<Y/NOUN/dobj	Forward
X/NOUN/pobj_<of/ADP/prep_<Y/NOUN/pobj_>and/CCONJ/cc	Reverse
X/NOUN/nsubj>_ship/NOUN/nsubj>_be/VERB/ROOT_<Y/NOUN/attr	Reverse
X/NOUN/nsubj>_missile/NOUN/nsubj>_be/VERB/ROOT_<Y/NOUN/attr	Forward
post/NOUN/compound<_X/NOUN/conj_<Y/NOUN/conj	Reverse
X/NOUN/pobj_<Y/NOUN/conj_>shirt/NOUN/conj	Reverse
X/NOUN/nsubj>_rifle/NOUN/nsubj>_be/VERB/ROOT_<Y/NOUN/attr	Forward
high/ADJ/amod<_X/NOUN/appos_<Y/NOUN/conj	Reverse
X/NOUN/nsubj>_vehicle/NOUN/nsubj>_be/VERB/ROOT_<Y/NOUN/attr	Reverse
X/NOUN/conj_<of/ADP/prep_<Y/NOUN/pobj	Reverse
X/NOUN/pobj_<by/ADP/prep_<commission/PROPN/pobj_<Y/PROPN/nmod	Forward
X/NOUN/dobj_<in/ADP/prep_<Y/PROPN/pobj	Reverse
tenor/NOUN/compound<_X/NOUN/appos_<Y/NOUN/conj	Reverse
alto/NOUN/compound<_X/NOUN/appos_<Y/NOUN/conj	Reverse
four/NUM/nummod<_X/NOUN/pobj_<Y/NOUN/appos	Reverse
X/NOUN/pobj_<of/ADP/prep_<Y/PROPN/pobj_>and/CCONJ/cc	Reverse
X/NOUN/pobj_<of/ADP/prep_<Y/PROPN/pobj_>hospital/PROPN/conj	Reverse
X/NOUN/pobj_<of/ADP/prep_<hospital/PROPN/pobj_<Y/PROPN/conj	Reverse
electric/ADJ/amod<_X/NOUN/pobj_<Y/NOUN/conj	Forward
X/NOUN/nsubj>_cathedral/NOUN/nsubj>_be/VERB/ROOT_<Y/NOUN/attr	Forward
X/NOUN/compound>_passenger/NOUN/compound>_Y/NOUN/ROOT	Reverse
X/NOUN/nsubj>_car/NOUN/nsubj>_feature/VERB/ROOT_<Y/NOUN/dobj	Forward
X/NOUN/nsubj>_house/NOUN/nsubj>_be/VERB/ROOT_<Y/PROPN/attr	Reverse
X/NOUN/nsubj>_grenade/NOUN/nsubj>_be/VERB/ROOT_<Y/NOUN/attr	Forward
X/NOUN/dobj_<trout/NOUN/conj_<Y/NOUN/conj_>eel/NOUN/conj	Forward
X/PROPN/nsubj>_hospital/PROPN/nsubj>_Y/NOUN/ROOT	Forward
X/NOUN/nsubj>_car/NOUN/nsubj>_be/VERB/ROOT_<Y/NOUN/attr	Forward
X/NOUN/dobj_<at/ADP/prep_<Y/NOUN/pobj	Reverse
X/NOUN/dobj_<of/ADP/prep_<Y/PROPN/pobj	Reverse
the/DET/det<_X/NOUN/dobj_<of/ADP/prep_<Y/PROPN/pobj	Reverse
an/DET/det<_X/NOUN/pobj_<of/ADP/prep_<Y/NOUN/pobj	Reverse
the/DET/det<_X/NOUN/appos_<of/ADP/prep_<Y/NOUN/pobj	Reverse
X/NOUN/nsubj_<know/VERB/acl_<as/ADP/prep_<Y/PROPN/pobj	Reverse
X/PROPN/compound>_district/PROPN/compound>_Y/NOUN/ROOT	Reverse
X/NOUN/nsubj>_building/NOUN/nsubj>_be/VERB/ROOT_<Y/NOUN/attr	Reverse
care/NOUN/compound<_X/NOUN/pobj_<of/ADP/prep_<Y/NOUN/pobj	Reverse
X/NOUN/nmod>_passenger/NOUN/nmod>_service/NOUN/ROOT_<Y/NOUN/compound	Reverse
other/ADJ/amod<_X/NOUN/pobj_<as/ADP/prep_<Y/NOUN/pobj	Reverse
X/NOUN/nsubjpass_<with/ADP/prep_<Y/NOUN/pobj	Forward
X/NOUN/compound>_hotel/NOUN/compound>_lot/NOUN/ROOT_<Y/NOUN/compound	Forward
X/NOUN/nsubj>_car/NOUN/nsubj>_Y/NOUN/ROOT	Forward
the/DET/det<_X/NOUN/nsubj>_car/NOUN/nsubj>_Y/NOUN/ROOT	Forward
X/NOUN/pobj_<at/ADP/prep_<Y/PROPN/pobj	Reverse
X/PROPN/appos_<Y/PROPN/conj_>of/ADP/prep	Forward
X/NOUN/pobj_<at/ADP/prep_<Y/PROPN/pobj_>in/ADP/prep	Reverse
tenor/NOUN/compound<_X/NOUN/pobj_<Y/NOUN/conj	Reverse
X/NOUN/nsubjpass_<on/ADP/prep_<Y/NOUN/pobj	Reverse
the/DET/det<_X/NOUN/nsubjpass_<on/ADP/prep_<Y/NOUN/pobj	Reverse
X/NOUN/nsubj>_cathedral/NOUN/nsubj>_have/VERB/ROOT_<Y/NOUN/dobj	Forward
X/NOUN/nsubj>_fish/NOUN/nsubj>_be/VERB/ROOT_<Y/NOUN/attr	Reverse
white/ADJ/amod<_X/NOUN/attr_<with/ADP/prep_<Y/NOUN/pobj	Forward
X/NOUN/attr_<with/ADP/prep_<Y/NOUN/pobj_>and/CCONJ/cc	Forward
some/DET/det<_X/NOUN/pobj_<Y/NOUN/conj	Reverse
X/NOUN/nsubj>_hotel/NOUN/nsubj>_feature/VERB/ROOT_<Y/NOUN/dobj	Forward
X/NOUN/nsubj>_fish/NOUN/nsubj>_include/VERB/ROOT_<Y/NOUN/dobj	Reverse
rainbow/NOUN/compound<_X/NOUN/dobj_<Y/NOUN/conj	Forward
steel/NOUN/compound<_X/NOUN/conj_<Y/NOUN/conj	Forward
veterinary/ADJ/amod<_X/NOUN/conj_<Y/NOUN/conj	Forward
X/NOUN/conj_<kit/NOUN/conj_<Y/NOUN/compound	Forward
bass/NOUN/compound<_X/NOUN/conj_<kit/NOUN/conj_<Y/NOUN/compound	Forward
X/NOUN/conj_<with/ADP/prep_<Y/NOUN/pobj	Forward
X/PROPN/compound>_poison/PROPN/compound>_Y/PROPN/ROOT	Reverse
X/NOUN/nsubj>_animal/NOUN/nsubj>_be/VERB/ROOT_<Y/NOUN/attr	Reverse
X/NOUN/compound>_poison/NOUN/compound>_Y/NOUN/ROOT	Reverse
X/NOUN/pobj_<Y/NOUN/appos_>with/ADP/prep	Forward
the/DET/det<_X/NOUN/attr_<of/ADP/prep_<Y/NOUN/pobj	Reverse
teaching/NOUN/compound<_X/NOUN/attr_<of/ADP/prep_<Y/PROPN/pobj	Forward
X/NOUN/attr_<of/ADP/prep_<Y/PROPN/pobj_>of/ADP/prep	Forward
ground/NOUN/compound<_X/NOUN/pobj_<of/ADP/prep_<Y/NOUN/pobj	Reverse
the/DET/det<_X/NOUN/pobj_<in/ADP/prep_<Y/PROPN/pobj	Reverse
top/ADJ/amod<_X/NOUN/pobj_<of/ADP/prep_<Y/NOUN/pobj	Reverse
main/ADJ/amod<_X/NOUN/pobj_<of/ADP/prep_<Y/PROPN/pobj	Reverse
X/NOUN/pobj_<of/ADP/prep_<Y/PROPN/pobj_>be/VERB/relcl	Reverse
lake/PROPN/compound<_X/NOUN/conj_<Y/NOUN/conj	Forward
X/PROPN/compound>_birch/PROPN/compound>_roll/PROPN/ROOT_<Y/PROPN/compound	Forward
X/PROPN/compound>_hospital/PROPN/compound>_school/PROPN/ROOT_<Y/PROPN/conj	Forward
an/DET/det<_X/NOUN/dobj_<of/ADP/prep_<Y/NOUN/pobj	Reverse
acoustic/ADJ/amod<_X/NOUN/appos_<Y/NOUN/conj	Forward
X/NOUN/dobj_<of/ADP/prep_<Y/PROPN/pobj_>in/ADP/prep	Reverse
breast/NOUN/compound<_X/NOUN/pobj_<of/ADP/prep_<Y/NOUN/pobj	Reverse
X/NOUN/pobj_<of/ADP/prep_<Y/NOUN/pobj_>or/CCONJ/cc	Reverse
X/NOUN/nsubj>_frigate/NOUN/nsubj>_be/VERB/ROOT_<Y/NOUN/attr	Forward
X/NOUN/pobj_<of/ADP/prep_<park/NOUN/pobj_<Y/NOUN/compound	Reverse
X/NOUN/attr_<Y/PROPN/conj	Forward
acoustic/ADJ/amod<_X/NOUN/dobj_<Y/NOUN/conj	Forward
mobile/ADJ/amod<_X/NOUN/conj_<Y/NOUN/conj	Forward
X/PROPN/dobj_<Y/PROPN/conj_>house/PROPN/conj	Forward
X/PROPN/dobj_<house/PROPN/conj_<Y/PROPN/conj	Forward
X/NOUN/nsubj>_bomb/NOUN/nsubj>_be/VERB/ROOT_<Y/NOUN/attr	Forward
X/NOUN/nmod_<Y/PROPN/conj	Forward
X/NOUN/compound>_fuel/NOUN/compound>_competition/NOUN/ROOT_<Y/NOUN/compound	Reverse
X/NOUN/nsubj>_gun/NOUN/nsubj>_fire/VERB/ROOT_<Y/NOUN/dobj	Forward
X/NOUN/pobj_<with/ADP/prep_<Y/NOUN/pobj	Forward
X/PROPN/compound>_paper/PROPN/compound>_records/PROPN/ROOT_<Y/PROPN/compound	Reverse
X/NOUN/conj_<actress/NOUN/conj_<Y/NOUN/compound	Reverse
X/NOUN/pobj_<of/ADP/prep_<Y/PROPN/pobj_>london/PROPN/appos	Reverse
several/ADJ/amod<_X/NOUN/dobj_<include/VERB/prep_<Y/NOUN/pobj	Reverse
model/PROPN/nmod<_X/NOUN/conj_<Y/NOUN/conj	Reverse
X/NOUN/ROOT_<be/VERB/conj_<Y/NOUN/attr	Forward
X/NOUN/pobj_<complete/ADJ/amod_<with/ADP/prep_<Y/NOUN/pobj	Forward
X/NOUN/poss>_car/NOUN/poss>_Y/NOUN/ROOT	Forward
the/DET/det<_X/NOUN/poss>_car/NOUN/poss>_Y/NOUN/ROOT	Forward
X/PROPN/nsubj>_hospital/PROPN/nsubj>_open/VERB/ROOT_<Y/NOUN/dobj	Forward
X/NOUN/appos_<Y/NOUN/conj_>mandolin/NOUN/conj	Forward
X/NOUN/nsubj>_car/NOUN/nsubj>_use/VERB/ROOT_<Y/NOUN/dobj	Forward
X/NOUN/nsubj>_gun/NOUN/nsubj>_be/VERB/ROOT_<Y/NOUN/attr	Forward
X/NOUN/nsubj>_hotel/NOUN/nsubj>_be/VERB/ROOT_<Y/NOUN/attr	Forward
top/ADJ/amod<_X/NOUN/pobj_<of/ADP/prep_<Y/PROPN/pobj	Reverse
X/NOUN/poss>_car/NOUN/poss>_economy/NOUN/ROOT_<Y/NOUN/compound	Forward
slide/NOUN/compound<_X/NOUN/conj_<Y/NOUN/conj	Forward
X/NOUN/nsubjpass_<of/ADP/prep_<Y/PROPN/pobj	Reverse
the/DET/det<_X/NOUN/nsubjpass_<of/ADP/prep_<Y/PROPN/pobj	Reverse
the/DET/det<_X/NOUN/conj_<of/ADP/prep_<Y/NOUN/pobj	Reverse
X/NOUN/nsubj>_pig/NOUN/nsubj>_be/VERB/ROOT_<Y/NOUN/attr	Forward
X/NOUN/compound>_diesel/NOUN/compound>_Y/NOUN/ROOT	Reverse
X/NOUN/nsubj>_tree/NOUN/nsubj>_be/VERB/ROOT_<Y/NOUN/attr	Reverse
X/NOUN/pobj_<in/ADP/prep_<Y/PROPN/pobj_>in/ADP/prep	Reverse
X/NOUN/nsubj_<with/ADP/prep_<Y/NOUN/pobj	Forward
X/NOUN/nsubj>_life/NOUN/nsubj>_be/VERB/ROOT_<Y/PROPN/attr	Reverse
X/PROPN/pobj_<Y/PROPN/conj_>of/ADP/prep	Forward
X/PROPN/compound>_tank/PROPN/compound>_company/NOUN/ROOT_<Y/PROPN/compound	Reverse
X/PROPN/compound>_rail/PROPN/compound>_station/NOUN/ROOT_<Y/NOUN/compound	Reverse
cable/NOUN/compound<_X/NOUN/dobj_<Y/NOUN/conj	Forward
new/ADJ/amod<_X/NOUN/nsubjpass_<Y/NOUN/conj	Forward
X/NOUN/compound>_school/NOUN/compound>_Y/NOUN/ROOT	Reverse
X/NOUN/pobj_<of/ADP/prep_<Y/NOUN/pobj_>park/VERB/acl	Reverse
X/NOUN/compound>_tail/NOUN/compound>_Y/NOUN/ROOT	Reverse
X/PROPN/compound>_bear/PROPN/compound>_lake/PROPN/ROOT_<Y/PROPN/compound	Forward
high/PROPN/compound<_X/PROPN/conj_<Y/PROPN/conj	Reverse
X/NOUN/compound>_stock/NOUN/compound>_racing/NOUN/ROOT_<Y/NOUN/compound	Reverse
X/NOUN/pobj_<Y/NOUN/conj_>guitar/NOUN/conj	Reverse
X/NOUN/pobj_<Y/NOUN/conj_>vocal/NOUN/conj	Forward
X/NOUN/nsubj>_building/NOUN/nsubj>_include/VERB/ROOT_<Y/NOUN/dobj	Reverse
X/NOUN/compound>_corn/NOUN/compound>_Y/NOUN/ROOT	Forward
teaching/NOUN/compound<_X/NOUN/pobj_<for/ADP/prep_<Y/PROPN/pobj	Forward
X/NOUN/pobj_<for/ADP/prep_<Y/PROPN/pobj_>of/ADP/prep	Forward
the/DET/det<_X/PROPN/nsubjpass_<Y/NOUN/appos	Forward
X/PROPN/compound>_elm/PROPN/compound>_beetle/PROPN/ROOT_<Y/PROPN/nmod	Forward
X/NOUN/nsubj>_car/NOUN/nsubj>_blow/VERB/ROOT_<Y/NOUN/dobj	Forward
high/ADJ/amod<_X/NOUN/pobj_<in/ADP/prep_<Y/PROPN/pobj	Reverse
X/NOUN/nsubj>_bus/NOUN/nsubj>_have/VERB/ROOT_<Y/NOUN/dobj	Forward
the/DET/det<_X/NOUN/dobj_<in/ADP/prep_<Y/NOUN/pobj	Reverse
X/PROPN/nsubj>_hospital/PROPN/nsubj>_be/VERB/ROOT_<Y/NOUN/attr	Forward
X/NOUN/pobj_<as/ADP/prep_<Y/PROPN/pobj	Reverse
the/DET/det<_X/NOUN/pobj_<as/ADP/prep_<Y/PROPN/pobj	Reverse
X/NOUN/conj_<at/ADP/prep_<Y/PROPN/pobj	Reverse
the/DET/det<_X/NOUN/conj_<at/ADP/prep_<Y/PROPN/pobj	Reverse
X/NOUN/nsubj>_carp/NOUN/nsubj>_be/VERB/ROOT_<Y/NOUN/attr	Forward
the/DET/det<_X/NOUN/pobj_<at/ADP/prep_<Y/PROPN/pobj	Reverse
maternity/NOUN/compound<_X/NOUN/pobj_<at/ADP/prep_<Y/PROPN/pobj	Reverse
X/NOUN/pobj_<as/ADP/prep_<Y/NOUN/pobj_>and/CCONJ/cc	Reverse
medical/PROPN/compound<_X/PROPN/pobj_<Y/NOUN/conj	Reverse
X/PROPN/nsubj>_cathedral/PROPN/nsubj>_have/VERB/ROOT_<Y/NOUN/dobj	Forward
X/NOUN/dobj_<of/ADP/prep_<Y/NOUN/pobj_>in/ADP/prep	Reverse
X/PROPN/compound>_hotel/PROPN/compound>_Y/NOUN/ROOT	Forward
X/NOUN/dobj_<as/ADP/prep_<Y/NOUN/pobj_>and/CCONJ/cc	Reverse
X/NOUN/pobj_<of/ADP/prep_<church/PROPN/pobj_<Y/PROPN/compound	Reverse
X/NOUN/amod>_elm/NOUN/amod>_beetle/NOUN/ROOT_<Y/NOUN/compound	Forward
fresh/ADJ/amod<_X/NOUN/pobj_<as/ADP/prep_<Y/NOUN/pobj	Reverse
X/NOUN/nsubj_<as/ADP/prep_<Y/NOUN/pobj	Reverse
string/NOUN/compound<_X/NOUN/conj_<Y/NOUN/conj	Forward
X/NOUN/conj_<Y/NOUN/conj_>mandolin/NOUN/conj	Forward
X/NOUN/conj_<juice/NOUN/conj_<Y/NOUN/compound	Reverse
X/NOUN/compound>_pear/NOUN/compound>_Y/NOUN/ROOT	Forward
X/PROPN/pobj_<Y/NOUN/appos_>in/ADP/prep	Forward
baritone/NOUN/compound<_X/NOUN/conj_<Y/NOUN/conj	Reverse
the/DET/det<_X/NOUN/nsubj_<with/ADP/prep_<Y/NOUN/pobj	Forward
right/ADJ/amod<_X/NOUN/pobj_<of/ADP/prep_<Y/NOUN/pobj	Reverse
X/NOUN/nsubj>_building/NOUN/nsubj>_be/VERB/ROOT_<Y/PROPN/attr	Reverse
X/NOUN/nsubj>_weapon/NOUN/nsubj>_be/VERB/ROOT_<Y/PROPN/attr	Reverse
X/NOUN/dobj_<Y/NOUN/conj_>fiddle/NOUN/conj	Forward
X/NOUN/pobj_<with/ADP/prep_<Y/NOUN/pobj_>and/CCONJ/cc	Forward
X/NOUN/nsubj>_moth/NOUN/nsubj>_be/VERB/ROOT_<Y/NOUN/attr	Forward
X/NOUN/compound>_apple/NOUN/compound>_Y/NOUN/ROOT	Forward
X/NOUN/nsubj>_building/NOUN/nsubj>_become/VERB/ROOT_<Y/PROPN/attr	Reverse
X/PROPN/pobj_<at/ADP/prep_<Y/PROPN/pobj_>in/ADP/prep	Reverse
sea/NOUN/compound<_X/NOUN/pobj_<Y/NOUN/conj	Forward
sleeve/NOUN/amod<_X/NOUN/pobj_<Y/NOUN/conj	Forward
X/NOUN/pobj_<Y/NOUN/conj_>hat/NOUN/conj	Forward
maternity/NOUN/compound<_X/NOUN/pobj_<of/ADP/prep_<Y/NOUN/pobj	Reverse
X/NOUN/pobj_<of/ADP/prep_<Y/NOUN/pobj_>be/VERB/relcl	Reverse
X/PROPN/compound>_lizard/PROPN/compound>_wilderness/PROPN/ROOT_<Y/PROPN/compound	Forward
chinook/PROPN/compound<_X/PROPN/conj_<Y/PROPN/conj	Reverse
third/ADJ/amod<_X/NOUN/pobj_<of/ADP/prep_<Y/PROPN/pobj	Reverse
the/DET/det<_X/NOUN/attr_<for/ADP/prep_<Y/NOUN/pobj	Reverse
X/PROPN/pobj_<in/ADP/prep_<Y/NOUN/pobj	Forward
X/NOUN/dobj_<of/ADP/prep_<Y/NOUN/pobj_>and/CCONJ/cc	Reverse
X/PROPN/compound>_salmon/PROPN/compound>_river/PROPN/ROOT_<Y/PROPN/compound	Reverse
left/ADJ/amod<_X/NOUN/pobj_<of/ADP/prep_<Y/NOUN/pobj	Reverse
X/NOUN/pobj_<of/ADP/prep_<Y/NOUN/pobj_>at/ADP/prep	Reverse
X/NOUN/dobj_<call/VERB/acl_<Y/NOUN/oprd	Reverse
high/ADJ/amod<_X/NOUN/pobj_<of/ADP/prep_<Y/PROPN/pobj	Reverse
X/NOUN/nsubjpass_<as/ADP/prep_<Y/NOUN/pobj_>and/CCONJ/cc	Reverse
X/NOUN/compound>_passenger/NOUN/compound>_service/NOUN/ROOT_<Y/NOUN/compound	Reverse
X/PROPN/pobj_<provide/VERB/relcl_<service/NOUN/dobj_<Y/NOUN/compound	Reverse
X/NOUN/dobj_<with/ADP/prep_<Y/NOUN/pobj_>and/CCONJ/cc	Forward
X/NOUN/nsubj>_building/NOUN/nsubj>_include/VERB/ROOT_<Y/PROPN/dobj	Reverse
X/NOUN/dobj_<at/ADP/prep_<Y/PROPN/pobj	Reverse
the/DET/det<_X/NOUN/dobj_<at/ADP/prep_<Y/PROPN/pobj	Reverse
X/NOUN/nsubj_<at/ADP/prep_<Y/NOUN/pobj	Reverse
the/DET/det<_X/NOUN/nsubj_<at/ADP/prep_<Y/NOUN/pobj	Reverse
X/NOUN/compound>_parking/NOUN/compound>_Y/NOUN/ROOT	Reverse
freshwater/NOUN/amod<_X/NOUN/pobj_<as/ADP/prep_<Y/NOUN/pobj	Reverse
cable/NOUN/compound<_X/NOUN/conj_<Y/NOUN/conj	Forward
X/NOUN/pobj_<per/ADP/prep_<Y/NOUN/pobj	Reverse
X/NOUN/nsubj>_missile/NOUN/nsubj>_carry/VERB/ROOT_<Y/NOUN/dobj	Forward
blue/ADJ/amod<_X/NOUN/pobj_<Y/NOUN/conj	Forward
X/PROPN/compound>_bear/PROPN/compound>_mountains/PROPN/ROOT_<Y/PROPN/compound	Forward
spanish/ADJ/amod<_X/NOUN/conj_<Y/NOUN/conj	Forward
X/NOUN/pobj_<of/ADP/prep_<Y/PROPN/pobj_>at/ADP/prep	Reverse
X/NOUN/pobj_<carry/VERB/acl_<Y/NOUN/dobj	Forward
white/ADJ/amod<_X/NOUN/attr_<Y/NOUN/conj	Forward
X/PROPN/nsubj>_pine/PROPN/nsubj>_be/VERB/ROOT_<Y/NOUN/attr	Forward
X/NOUN/nsubj>_gun/NOUN/nsubj>_have/VERB/ROOT_<Y/NOUN/dobj	Forward
X/NOUN/compound>_air/NOUN/compound>_service/NOUN/ROOT_<Y/NOUN/compound	Reverse
psychiatric/ADJ/amod<_X/NOUN/pobj_<of/ADP/prep_<Y/PROPN/pobj	Reverse
X/NOUN/nsubj_<of/ADP/prep_<Y/PROPN/pobj	Reverse
the/DET/det<_X/NOUN/nsubj_<of/ADP/prep_<Y/PROPN/pobj	Reverse
X/NOUN/nsubj_<at/ADP/prep_<Y/PROPN/pobj	Reverse
X/NOUN/compound>_air/NOUN/compound>_helicopter/NOUN/ROOT_<Y/NOUN/compound	Reverse
X/NOUN/attr_<relate/VERB/acl_<to/ADP/prep_<Y/NOUN/pobj	Reverse
X/NOUN/nsubj>_lion/NOUN/nsubj>_be/VERB/ROOT_<Y/NOUN/attr	Forward
first/ADJ/amod<_X/NOUN/pobj_<of/ADP/prep_<Y/PROPN/pobj	Reverse
acoustic/ADJ/amod<_X/NOUN/pobj_<Y/NOUN/conj	Forward
the/DET/det<_X/NOUN/conj_<on/ADP/prep_<Y/NOUN/pobj	Reverse
sport/NOUN/compound<_X/NOUN/compound>_car/NOUN/compound>_Y/NOUN/ROOT	Forward
X/NOUN/compound>_rail/NOUN/compound>_Y/NOUN/ROOT	Reverse
X/NOUN/compound>_air/NOUN/compound>_Y/NOUN/ROOT	Reverse
X/NOUN/nsubj_<include/VERB/prep_<Y/NOUN/pobj	Reverse
X/NOUN/attr_<Y/NOUN/appos_>of/ADP/prep	Forward
X/NOUN/conj_<Y/NOUN/conj_>zapote/NOUN/conj	Forward
X/NOUN/attr_<for/ADP/prep_<Y/PROPN/pobj	Forward
the/DET/det<_X/NOUN/attr_<for/ADP/prep_<Y/PROPN/pobj	Forward
primary/ADJ/amod<_X/NOUN/attr_<for/ADP/prep_<Y/PROPN/pobj	Forward
teaching/NOUN/compound<_X/NOUN/attr_<for/ADP/prep_<Y/PROPN/pobj	Forward
X/NOUN/attr_<for/ADP/prep_<Y/PROPN/pobj_>of/ADP/prep	Forward
X/NOUN/nmod>_dog/NOUN/nmod>_Y/NOUN/ROOT	Reverse
X/PROPN/poss_<Y/PROPN/conj	Forward
X/PROPN/poss_<Y/PROPN/conj_>'s/PART/case	Forward
X/PROPN/compound>_lizard/PROPN/compound>_pass/PROPN/ROOT_<Y/PROPN/compound	Forward
X/NOUN/compound>_vehicle/NOUN/compound>_service/NOUN/ROOT_<Y/NOUN/compound	Reverse
X/NOUN/nsubj>_building/NOUN/nsubj>_become/VERB/ROOT_<Y/NOUN/attr	Reverse
medical/ADJ/amod<_X/NOUN/pobj_<Y/NOUN/conj	Reverse
X/NOUN/compound>_steam/NOUN/compound>_Y/NOUN/ROOT	Reverse
X/NOUN/dobj_<like/ADP/prep_<Y/NOUN/pobj	Reverse
X/NOUN/conj_<car/NOUN/conj_<Y/NOUN/compound	Forward
X/NOUN/nsubj>_salmon/NOUN/nsubj>_be/VERB/ROOT_<Y/NOUN/attr	Forward
X/NOUN/attr_<win/VERB/relcl_<in/ADP/prep_<Y/NOUN/pobj	Reverse
X/NOUN/nsubj>_jacket/NOUN/nsubj>_have/VERB/ROOT_<Y/NOUN/dobj	Forward
an/DET/det<_X/NOUN/dobj_<with/ADP/prep_<Y/NOUN/pobj	Forward
X/NOUN/ROOT_<of/ADP/prep_<Y/NOUN/pobj	Reverse
X/NOUN/nsubj>_rifle/NOUN/nsubj>_have/VERB/ROOT_<Y/NOUN/dobj	Forward
X/NOUN/attr_<of/ADP/prep_<Y/NOUN/pobj_>in/ADP/prep	Reverse
X/NOUN/nsubj>_bear/NOUN/nsubj>_be/VERB/ROOT_<Y/NOUN/attr	Forward
care/PROPN/compound<_X/PROPN/pobj_<at/ADP/prep_<Y/PROPN/pobj	Reverse
X/NOUN/compound>_stock/NOUN/compound>_Y/NOUN/ROOT	Reverse
X/NOUN/dobj_<Y/NOUN/conj_>trout/NOUN/conj	Reverse
X/NOUN/pobj_<include/VERB/prep_<Y/PROPN/pobj	Reverse
X/NOUN/pobj_<train/NOUN/conj_<Y/NOUN/compound	Forward
X/PROPN/pobj_<of/ADP/prep_<Y/NOUN/pobj	Reverse
X/PROPN/dobj_<at/ADP/prep_<Y/PROPN/pobj	Reverse
X/NOUN/nsubj>_weapon/NOUN/nsubj>_include/VERB/ROOT_<Y/NOUN/dobj	Reverse
X/NOUN/appos_<of/ADP/prep_<family/NOUN/pobj_<Y/NOUN/compound	Reverse
X/NOUN/nsubj>_guitar/NOUN/nsubj>_have/VERB/ROOT_<Y/NOUN/dobj	Forward
X/PROPN/compound>_ferry/PROPN/compound>_inn/PROPN/ROOT_<Y/PROPN/compound	Forward
X/PROPN/appos_<Y/PROPN/conj_>rosemary/PROPN/conj	Forward
X/PROPN/appos_<sage/PROPN/conj_<Y/PROPN/conj	Forward
X/PROPN/appos_<sage/PROPN/conj_<Y/PROPN/conj_>and/CCONJ/cc	Forward
X/PROPN/appos_<sage/PROPN/conj_<Y/PROPN/conj_>thyme/PROPN/conj	Forward
X/NOUN/nsubj>_tree/NOUN/nsubj>_include/VERB/ROOT_<Y/NOUN/dobj	Reverse
X/NOUN/conj_<Y/NOUN/conj_>boot/NOUN/conj	Forward
harvard/PROPN/compound<_X/PROPN/pobj_<Y/PROPN/conj	Reverse
medical/PROPN/compound<_X/PROPN/pobj_<Y/PROPN/conj	Reverse
X/PROPN/compound>_eagle/PROPN/compound>_owl/PROPN/ROOT_<Y/PROPN/appos	Reverse
X/NOUN/dobj_<at/ADP/prep_<Y/PROPN/pobj_>in/ADP/prep	Reverse
main/ADJ/amod<_X/NOUN/dobj_<of/ADP/prep_<Y/NOUN/pobj	Reverse
X/PROPN/compound>_air/PROPN/compound>_trust/PROPN/ROOT_<Y/PROPN/compound	Reverse
especially/ADV/advmod<_X/NOUN/conj_<Y/NOUN/conj	Reverse
farmed/ADJ/amod<_X/NOUN/pobj_<Y/NOUN/conj	Reverse
various/ADJ/amod<_X/NOUN/pobj_<include/VERB/prep_<Y/NOUN/pobj	Reverse
X/NOUN/pobj_<like/ADP/prep_<Y/NOUN/pobj	Reverse
X/PROPN/compound>_glass/PROPN/compound>_company/PROPN/ROOT_<Y/PROPN/compound	Reverse
X/NOUN/pobj_<in/ADP/prep_<family/NOUN/pobj_<Y/NOUN/compound	Reverse
X/NOUN/pobj_<of/ADP/prep_<Y/NOUN/pobj_>near/ADP/prep	Reverse
mobile/ADJ/amod<_X/NOUN/pobj_<Y/NOUN/conj	Forward
coho/NOUN/compound<_X/NOUN/conj_<Y/NOUN/conj	Reverse
-pron-/ADJ/poss<_X/NOUN/pobj_<at/ADP/prep_<Y/PROPN/pobj	Reverse
X/NOUN/nsubj>_passenger/NOUN/nsubj>_take/VERB/ROOT_<Y/NOUN/dobj	Reverse
X/NOUN/pobj_<as/ADP/prep_<Y/NOUN/pobj_>or/CCONJ/cc	Reverse
atlantic/PROPN/compound<_X/NOUN/dobj_<Y/NOUN/conj	Reverse
X/NOUN/nsubj>_car/NOUN/nsubj>_carry/VERB/ROOT_<Y/NOUN/dobj	Forward
main/ADJ/amod<_X/NOUN/pobj_<Y/NOUN/conj	Forward
X/NOUN/attr_<operate/VERB/acl_<by/ADP/agent_<Y/PROPN/pobj	Forward
X/PROPN/compound>_pine/PROPN/compound>_state/PROPN/ROOT_<Y/PROPN/compound	Forward
X/NOUN/dobj_<as/ADP/prep_<Y/NOUN/pobj_>or/CCONJ/cc	Reverse
white/ADJ/amod<_X/NOUN/dobj_<with/ADP/prep_<Y/NOUN/pobj	Forward
standard/ADJ/amod<_X/NOUN/conj_<Y/NOUN/conj	Forward
lake/NOUN/compound<_X/NOUN/conj_<Y/NOUN/conj	Forward
X/NOUN/poss>_pig/NOUN/poss>_Y/NOUN/ROOT	Forward
X/NOUN/nsubj>_snake/NOUN/nsubj>_have/VERB/ROOT_<Y/NOUN/dobj	Forward
X/NOUN/nsubj>_missile/NOUN/nsubj>_have/VERB/ROOT_<Y/NOUN/dobj	Forward
X/NOUN/attr_<at/ADP/prep_<Y/PROPN/pobj	Reverse
X/NOUN/pobj_<bass/NOUN/conj_<Y/NOUN/conj_>piano/NOUN/conj	Forward
X/PROPN/compound>_district/PROPN/compound>_Y/PROPN/ROOT	Reverse
X/NOUN/pobj_<against/ADP/prep_<Y/PROPN/pobj	Reverse
top/ADJ/amod<_X/NOUN/dobj_<of/ADP/prep_<Y/NOUN/pobj	Reverse
X/NOUN/ROOT_<of/ADP/prep_<Y/PROPN/pobj	Reverse
X/NOUN/nmod>_hospital/NOUN/nmod>_Y/NOUN/ROOT	Forward
X/NOUN/attr_<to/ADP/prep_<Y/NOUN/pobj	Reverse
game/NOUN/compound<_X/NOUN/pobj_<as/ADP/prep_<Y/NOUN/pobj	Reverse
X/NOUN/nsubj>_driver/NOUN/nsubj>_drive/VERB/ROOT_<Y/NOUN/dobj	Reverse
X/NOUN/attr_<locate/VERB/acl_<in/ADP/prep_<Y/NOUN/pobj	Forward
the/DET/det<_X/NOUN/nsubj_<at/ADP/prep_<Y/PROPN/pobj	Reverse
X/NOUN/compound>_rocket/NOUN/compound>_Y/NOUN/ROOT	Reverse
X/PROPN/compound>_light/PROPN/compound>_club/NOUN/ROOT_<Y/PROPN/compound	Reverse
X/PROPN/compound>_air/PROPN/compound>_service/PROPN/ROOT_<Y/PROPN/compound	Reverse
bass/NOUN/compound<_X/NOUN/conj_<set/NOUN/conj_<Y/NOUN/compound	Forward
X/NOUN/nsubj>_trout/NOUN/nsubj>_be/VERB/ROOT_<Y/NOUN/attr	Forward
X/NOUN/pobj_<Y/NOUN/appos_>of/ADP/prep	Forward
X/NOUN/poss_<Y/PROPN/conj	Forward
X/NOUN/poss_<Y/PROPN/conj_>'s/PART/case	Forward
X/NOUN/conj_<of/ADP/prep_<Y/PROPN/pobj	Reverse
the/DET/det<_X/NOUN/conj_<of/ADP/prep_<Y/PROPN/pobj	Reverse
the/DET/det<_X/NOUN/pobj_<have/VERB/relcl_<Y/NOUN/dobj	Forward
X/PROPN/compound>_villa/PROPN/compound>_Y/NOUN/ROOT	Forward
mobile/ADJ/amod<_X/NOUN/pobj_<as/ADP/prep_<Y/NOUN/pobj	Reverse
X/NOUN/nsubj>_cat/NOUN/nsubj>_be/VERB/ROOT_<Y/NOUN/attr	Forward
X/NOUN/nsubj>_rifle/NOUN/nsubj>_use/VERB/ROOT_<Y/NOUN/dobj	Forward
bass/NOUN/compound<_X/NOUN/appos_<Y/NOUN/conj	Forward
X/NOUN/pobj_<of/ADP/prep_<Y/NOUN/pobj_>from/ADP/prep	Reverse
care/NOUN/compound<_X/NOUN/pobj_<of/ADP/prep_<Y/PROPN/pobj	Reverse
X/NOUN/nsubj>_dove/NOUN/nsubj>_be/VERB/ROOT_<Y/NOUN/attr	Reverse
X/PROPN/nsubj>_eagle/PROPN/nsubj>_be/VERB/ROOT_<Y/NOUN/attr	Forward
X/NOUN/dobj_<know/VERB/acl_<as/ADP/prep_<Y/NOUN/pobj	Reverse
tiger/PROPN/compound<_X/NOUN/pobj_<Y/PROPN/conj	Reverse
X/NOUN/pobj_<Y/PROPN/conj_>turtle/NOUN/conj	Reverse
X/NOUN/nsubj>_produce/NOUN/nsubj>_include/VERB/ROOT_<Y/NOUN/dobj	Reverse
X/NOUN/pobj_<with/ADP/prep_<Y/NOUN/pobj_>of/ADP/prep	Forward
care/PROPN/compound<_X/PROPN/pobj_<of/ADP/prep_<Y/PROPN/pobj	Reverse
X/PROPN/nsubj>_dove/PROPN/nsubj>_be/VERB/ROOT_<Y/NOUN/attr	Reverse
X/PROPN/compound>_point/PROPN/compound>_system/PROPN/ROOT_<Y/PROPN/compound	Reverse
polo/NOUN/compound<_X/NOUN/pobj_<Y/NOUN/conj	Forward
the/DET/det<_X/NOUN/dobj_<be/VERB/relcl_<Y/NOUN/attr	Forward
X/NOUN/attr_<at/ADP/prep_<Y/NOUN/pobj	Reverse
small/ADJ/amod<_X/NOUN/attr_<with/ADP/prep_<Y/NOUN/pobj	Forward
open/ADJ/amod<_X/NOUN/pobj_<of/ADP/prep_<Y/NOUN/pobj	Reverse
an/DET/det<_X/NOUN/attr_<with/ADP/prep_<Y/NOUN/pobj	Forward
X/NOUN/dobj_<of/ADP/prep_<track/NOUN/pobj_<Y/NOUN/compound	Reverse
many/ADJ/amod<_X/NOUN/pobj_<as/ADP/prep_<Y/NOUN/pobj	Reverse
an/DET/det<_X/NOUN/pobj_<as/ADP/prep_<Y/NOUN/pobj	Reverse
X/NOUN/dobj_<of/ADP/prep_<Y/NOUN/pobj_>at/ADP/prep	Reverse
chinook/NOUN/compound<_X/NOUN/pobj_<Y/NOUN/conj	Reverse
sockeye/NOUN/compound<_X/NOUN/conj_<Y/NOUN/conj	Reverse
X/NOUN/nsubj>_castle/NOUN/nsubj>_have/VERB/ROOT_<Y/NOUN/dobj	Forward
X/NOUN/compound>_phone/NOUN/compound>_Y/NOUN/ROOT	Forward
X/NOUN/compound>_guitar/NOUN/compound>_Y/NOUN/ROOT	Forward
american/ADJ/amod<_X/NOUN/dobj_<Y/NOUN/conj	Reverse
heavy/ADJ/amod<_X/NOUN/attr_<with/ADP/prep_<Y/NOUN/pobj	Forward
X/NOUN/pobj_<carry/VERB/relcl_<Y/NOUN/dobj	Forward
X/NOUN/compound>_pineapple/NOUN/compound>_Y/NOUN/ROOT	Forward
floor/NOUN/compound<_X/NOUN/pobj_<of/ADP/prep_<Y/PROPN/pobj	Reverse
X/NOUN/nsubj>_hospital/NOUN/nsubj>_be/VERB/ROOT_<Y/NOUN/attr	Forward
X/NOUN/compound>_weapon/NOUN/compound>_Y/NOUN/ROOT	Reverse
X/NOUN/pobj_<inside/ADP/prep_<Y/NOUN/pobj	Reverse
X/NOUN/pobj_<Y/NOUN/conj_>fish/NOUN/conj	Forward
X/NOUN/attr_<Y/NOUN/appos_>and/CCONJ/cc	Forward
X/NOUN/pobj_<like/ADP/prep_<Y/NOUN/pobj_>and/CCONJ/cc	Reverse
X/NOUN/compound>_vehicle/NOUN/compound>_Y/NOUN/ROOT	Reverse
sandringham/PROPN/compound<_X/PROPN/pobj_<Y/PROPN/conj	Reverse
-pron-/ADJ/poss<_X/PROPN/dobj_<Y/PROPN/conj	Reverse
X/NOUN/nsubjpass_<at/ADP/prep_<Y/PROPN/pobj	Reverse
rock/NOUN/compound<_X/NOUN/conj_<Y/NOUN/conj	Reverse
northern/ADJ/amod<_X/NOUN/dobj_<Y/NOUN/conj	Forward
X/NOUN/compound>_glass/NOUN/compound>_Y/NOUN/ROOT	Reverse
X/NOUN/conj_<with/ADP/prep_<Y/NOUN/pobj_>and/CCONJ/cc	Forward
X/NOUN/nsubjpass_<like/ADP/prep_<Y/NOUN/pobj	Reverse
wild/ADJ/amod<_X/NOUN/pobj_<include/VERB/prep_<Y/NOUN/pobj	Reverse
X/NOUN/nsubj>_corn/NOUN/nsubj>_be/VERB/ROOT_<Y/NOUN/attr	Forward
X/NOUN/nsubj>_apple/NOUN/nsubj>_be/VERB/ROOT_<Y/NOUN/attr	Forward
X/NOUN/nsubj>_shirt/NOUN/nsubj>_be/VERB/ROOT_<Y/NOUN/attr	Forward
X/NOUN/attr_<to/ADP/prep_<Y/PROPN/pobj	Reverse
pacific/PROPN/compound<_X/NOUN/pobj_<Y/NOUN/conj	Reverse
X/NOUN/poss>_snake/NOUN/poss>_Y/NOUN/ROOT	Forward
an/DET/det<_X/NOUN/conj_<of/ADP/prep_<Y/NOUN/pobj	Reverse
X/NOUN/dobj_<Y/NOUN/conj_>tilapia/NOUN/conj	Reverse
lake/NOUN/compound<_X/NOUN/pobj_<Y/NOUN/conj	Forward
X/NOUN/conj_<trout/NOUN/conj_<Y/NOUN/conj_>bass/NOUN/conj	Forward
X/NOUN/dobj_<than/ADP/prep_<Y/NOUN/pobj	Reverse
tenor/NOUN/compound<_X/NOUN/conj_<Y/NOUN/conj	Reverse
X/PROPN/compound>_air/PROPN/compound>_Y/PROPN/ROOT	Reverse
class/NOUN/compound<_X/NOUN/attr_<Y/NOUN/appos	Forward
X/NOUN/compound>_food/NOUN/compound>_Y/NOUN/ROOT	Reverse
X/PROPN/compound>_branch/PROPN/compound>_creek/PROPN/ROOT_<Y/PROPN/compound	Reverse
X/NOUN/nsubj>_villa/NOUN/nsubj>_be/VERB/ROOT_<Y/NOUN/attr	Forward
X/NOUN/nsubj>_castle/NOUN/nsubj>_comprise/VERB/ROOT_<Y/NOUN/dobj	Forward
X/NOUN/nsubj>_hospital/NOUN/nsubj>_open/VERB/ROOT_<Y/NOUN/dobj	Forward
X/NOUN/compound>_hospital/NOUN/compound>_Y/NOUN/ROOT	Forward
high/ADJ/amod<_X/NOUN/pobj_<Y/NOUN/conj	Reverse
X/PROPN/compound>_castle/PROPN/compound>_Y/PROPN/ROOT	Forward
bass/NOUN/compound<_X/NOUN/parataxis_<Y/NOUN/conj	Forward
X/PROPN/compound>_paper/PROPN/compound>_co./PROPN/ROOT_<Y/PROPN/compound	Reverse
X/NOUN/dobj_<call/VERB/acl_<Y/PROPN/oprd	Reverse
X/NOUN/nsubj>_jacket/NOUN/nsubj>_be/VERB/ROOT_<Y/NOUN/attr	Forward
X/NOUN/attr_<Y/NOUN/appos_>with/ADP/prep	Forward
X/NOUN/nsubj>_shirt/NOUN/nsubj>_Y/NOUN/ROOT	Forward
office/NOUN/compound<_X/NOUN/conj_<Y/NOUN/conj	Reverse
psychiatric/ADJ/amod<_X/NOUN/pobj_<at/ADP/prep_<Y/PROPN/pobj	Reverse
X/NOUN/nsubj>_hospital/NOUN/nsubj>_offer/VERB/ROOT_<Y/NOUN/dobj	Forward
surgical/ADJ/amod<_X/NOUN/pobj_<of/ADP/prep_<Y/PROPN/pobj	Reverse
X/PROPN/compound>_stock/PROPN/compound>_racing/NOUN/ROOT_<Y/NOUN/compound	Reverse
X/NOUN/nsubj>_pine/NOUN/nsubj>_be/VERB/ROOT_<Y/NOUN/attr	Forward
X/NOUN/nsubj>_phone/NOUN/nsubj>_be/VERB/ROOT_<Y/NOUN/attr	Forward
X/NOUN/ROOT_<for/ADP/prep_<Y/NOUN/pobj	Reverse
garter/NOUN/amod<_X/NOUN/conj_<Y/NOUN/conj	Reverse
cell/NOUN/compound<_X/NOUN/pobj_<Y/NOUN/conj	Forward
X/NOUN/compound>_television/NOUN/compound>_show/NOUN/ROOT_<Y/NOUN/appos	Forward
X/NOUN/compound>_fish/NOUN/compound>_Y/NOUN/ROOT	Reverse
X/PROPN/compound>_pine/PROPN/compound>_school/PROPN/ROOT_<Y/PROPN/compound	Forward
south/ADJ/amod<_X/NOUN/pobj_<of/ADP/prep_<Y/PROPN/pobj	Reverse
X/NOUN/nsubj>_cod/NOUN/nsubj>_be/VERB/ROOT_<Y/NOUN/attr	Forward
X/PROPN/nsubj>_gun/PROPN/nsubj>_be/VERB/ROOT_<Y/NOUN/attr	Forward
the/DET/det<_X/PROPN/pobj_<of/ADP/prep_<Y/NOUN/pobj	Reverse
upper/ADJ/amod<_X/NOUN/pobj_<of/ADP/prep_<Y/NOUN/pobj	Reverse
X/NOUN/pobj_<specie/NOUN/conj_<Y/NOUN/compound	Forward
back/ADJ/amod<_X/NOUN/pobj_<of/ADP/prep_<Y/NOUN/pobj	Reverse
the/DET/det<_X/NOUN/dobj_<on/ADP/prep_<Y/NOUN/pobj	Reverse
X/NOUN/pobj_<base/VERB/acl_<on/ADP/prep_<Y/NOUN/pobj	Reverse
X/NOUN/pobj_<Y/NOUN/conj_>trout/NOUN/conj	Reverse
X/PROPN/compound>_stock/PROPN/compound>_brasil/NOUN/ROOT_<Y/PROPN/compound	Reverse
X/NOUN/pobj_<food/NOUN/conj_<Y/NOUN/compound	Forward
X/NOUN/nmod>_guitar/NOUN/nmod>_vocal/NOUN/ROOT_<Y/NOUN/nmod	Forward
coho/ADJ/compound<_X/NOUN/pobj_<Y/NOUN/conj	Reverse
X/NOUN/nsubj>_building/NOUN/nsubj>_house/VERB/ROOT_<Y/PROPN/dobj	Reverse
X/NOUN/nsubj>_tree/NOUN/nsubj>_be/VERB/ROOT_<Y/PROPN/attr	Reverse
X/NOUN/nsubj>_vessel/NOUN/nsubj>_be/VERB/ROOT_<Y/NOUN/attr	Reverse
X/NOUN/compound>_birch/NOUN/compound>_scroll/NOUN/ROOT_<Y/NOUN/compound	Forward
memorial/PROPN/compound<_X/PROPN/pobj_<Y/PROPN/conj	Forward
X/NOUN/nsubj>_food/NOUN/nsubj>_include/VERB/ROOT_<Y/NOUN/dobj	Reverse
freshwater/NOUN/amod<_X/NOUN/pobj_<Y/NOUN/appos	Reverse
X/NOUN/dobj_<use/VERB/acl_<as/ADP/prep_<Y/NOUN/pobj	Forward
X/NOUN/nsubj>_hotel/NOUN/nsubj>_Y/NOUN/ROOT	Forward
the/DET/det<_X/NOUN/nsubj>_hotel/NOUN/nsubj>_Y/NOUN/ROOT	Forward
X/NOUN/nsubj>_bus/NOUN/nsubj>_be/VERB/ROOT_<Y/NOUN/attr	Forward
X/NOUN/pobj_<drive/VERB/acl_<by/ADP/agent_<Y/NOUN/pobj	Forward
X/NOUN/pobj_<in/ADP/prep_<Y/NOUN/pobj_>in/ADP/prep	Reverse
the/DET/det<_X/NOUN/nsubjpass_<at/ADP/prep_<Y/PROPN/pobj	Reverse
the/DET/det<_X/NOUN/nsubjpass_<Y/PROPN/appos	Reverse
X/NOUN/nsubj>_hospital/NOUN/nsubj>_employ/VERB/ROOT_<Y/NOUN/dobj	Forward
X/NOUN/poss>_lion/NOUN/poss>_Y/NOUN/ROOT	Forward
X/NOUN/pobj_<of/ADP/prep_<Y/NOUN/pobj_>on/ADP/prep	Reverse
X/NOUN/nsubj>_conifer/NOUN/nsubj>_include/VERB/ROOT_<Y/NOUN/dobj	Reverse
X/NOUN/compound>_tank/NOUN/compound>_Y/NOUN/ROOT	Reverse
water/NOUN/compound<_X/NOUN/pobj_<as/ADP/prep_<Y/NOUN/pobj	Reverse
the/DET/det<_X/PROPN/attr_<Y/NOUN/appos	Forward
12-string/NUM/amod<_X/NOUN/dobj_<Y/NOUN/conj	Forward
X/NOUN/dobj_<Y/NOUN/conj_>school/NOUN/conj	Forward
X/NOUN/nmod>_floor/NOUN/nmod>_body/NOUN/ROOT_<Y/NOUN/compound	Reverse
X/NOUN/nmod>_hotel/NOUN/nmod>_Y/NOUN/ROOT	Forward
X/NOUN/conj_<Y/NOUN/conj_>motel/NOUN/conj	Reverse
the/DET/det<_X/NOUN/nsubj_<from/ADP/prep_<Y/NOUN/pobj	Reverse
X/NOUN/nsubj_<as/ADP/prep_<Y/NOUN/pobj_>and/CCONJ/cc	Reverse
X/NOUN/poss>_car/NOUN/poss>_tank/NOUN/ROOT_<Y/NOUN/compound	Forward
two/NUM/nummod<_X/NOUN/dobj_<of/ADP/prep_<Y/NOUN/pobj	Reverse
X/PROPN/appos_<Y/PROPN/conj_>shield/PROPN/conj	Reverse
X/NOUN/nsubj>_fruit/NOUN/nsubj>_be/VERB/ROOT_<Y/NOUN/attr	Reverse
X/NOUN/compound>_passenger/NOUN/compound>_train/NOUN/ROOT_<Y/NOUN/appos	Reverse
X/NOUN/nsubj>_fish/NOUN/nsubj>_Y/NOUN/ROOT	Reverse
X/NOUN/nsubj>_guitar/NOUN/nsubj>_feature/VERB/ROOT_<Y/NOUN/dobj	Forward
X/NOUN/pobj_<from/ADP/prep_<Y/PROPN/pobj	Reverse
X/NOUN/pobj_<include/VERB/relcl_<Y/NOUN/dobj	Reverse
X/NOUN/pobj_<of/ADP/prep_<tree/NOUN/pobj_<Y/NOUN/compound	Reverse
X/NOUN/conj_<Y/NOUN/parataxis	Reverse
medical/ADJ/amod<_X/NOUN/dobj_<Y/NOUN/conj	Reverse
teaching/NOUN/compound<_X/NOUN/conj_<Y/NOUN/conj	Forward
X/PROPN/pobj_<into/ADP/prep_<Y/PROPN/pobj	Forward
dress/NOUN/compound<_X/NOUN/pobj_<Y/NOUN/appos	Reverse
psychiatric/ADJ/amod<_X/NOUN/pobj_<Y/NOUN/conj	Forward
X/PROPN/nsubj>_hospital/PROPN/nsubj>_have/VERB/ROOT_<Y/NOUN/dobj	Forward
three/NUM/nummod<_X/NOUN/dobj_<Y/NOUN/conj	Reverse
X/NOUN/nsubj>_hospital/NOUN/nsubj>_include/VERB/ROOT_<Y/NOUN/dobj	Forward
X/NOUN/conj_<pollock/NOUN/conj_<Y/NOUN/conj_>and/CCONJ/cc	Forward
X/NOUN/conj_<pollock/NOUN/conj_<Y/NOUN/conj_>tuna/NOUN/conj	Forward
X/NOUN/conj_<pollock/NOUN/conj_<Y/NOUN/conj_>march/PROPN/npadvmod	Reverse
wild/PROPN/amod<_X/NOUN/conj_<Y/NOUN/conj	Reverse
X/NOUN/compound>_leaf/NOUN/compound>_Y/NOUN/ROOT	Reverse
X/NOUN/compound>_acacia/NOUN/compound>_Y/NOUN/ROOT	Forward
X/NOUN/nsubj_<Y/NOUN/conj_>of/ADP/prep	Forward
bed/NOUN/compound<_X/NOUN/conj_<Y/NOUN/conj	Forward
X/NOUN/pobj_<of/ADP/prep_<Y/NOUN/pobj_>drive/VERB/acl	Reverse
X/PROPN/compound>_steam/PROPN/compound>_passes/PROPN/ROOT_<Y/NOUN/compound	Reverse
X/NOUN/dobj_<for/ADP/prep_<Y/PROPN/pobj	Reverse
X/NOUN/nsubj>_fruit/NOUN/nsubj>_include/VERB/ROOT_<Y/NOUN/dobj	Reverse
X/PROPN/nsubjpass_<of/ADP/prep_<Y/PROPN/pobj	Reverse
the/DET/det<_X/PROPN/nsubjpass_<of/ADP/prep_<Y/PROPN/pobj	Reverse
X/PROPN/compound>_passenger/PROPN/compound>_Y/PROPN/ROOT	Reverse
X/PROPN/conj_<Y/PROPN/conj_>hall/PROPN/conj	Forward
bald/ADJ/amod<_X/NOUN/attr_<Y/NOUN/appos	Reverse
second/ADJ/amod<_X/NOUN/pobj_<of/ADP/prep_<Y/PROPN/pobj	Reverse
X/PROPN/nsubj>_villa/PROPN/nsubj>_win/VERB/ROOT_<Y/NOUN/dobj	Forward
X/PROPN/compound>_pine/PROPN/compound>_council/PROPN/ROOT_<Y/PROPN/compound	Forward
general/PROPN/compound<_X/PROPN/conj_<Y/PROPN/conj	Forward
X/PROPN/compound>_hospital/PROPN/compound>_Y/PROPN/ROOT	Forward
X/PROPN/nsubjpass_<know/VERB/acl_<as/ADP/prep_<Y/PROPN/pobj	Reverse
X/NOUN/compound>_plastic/NOUN/compound>_Y/NOUN/ROOT	Reverse
X/NOUN/nsubj>_furniture/NOUN/nsubj>_include/VERB/ROOT_<Y/NOUN/dobj	Reverse
X/NOUN/poss>_lizard/NOUN/poss>_Y/NOUN/ROOT	Forward
X/NOUN/nsubj>_stock/NOUN/nsubj>_include/VERB/ROOT_<Y/NOUN/dobj	Reverse
the/DET/det<_X/NOUN/poss>_lizard/NOUN/poss>_Y/NOUN/ROOT	Forward
X/NOUN/compound>_birch/NOUN/compound>_letter/NOUN/ROOT_<Y/NOUN/compound	Forward
health/NOUN/compound<_X/NOUN/attr_<Y/NOUN/conj	Reverse
X/NOUN/nsubj>_hotel/NOUN/nsubj>_contain/VERB/ROOT_<Y/NOUN/dobj	Forward
several/ADJ/amod<_X/NOUN/pobj_<include/VERB/prep_<Y/NOUN/pobj	Reverse
X/NOUN/dobj_<Y/NOUN/conj_>shoe/NOUN/conj	Forward
X/PROPN/dobj_<Y/PROPN/conj_>of/ADP/prep	Forward
chunk/NOUN/compound<_X/NOUN/conj_<Y/NOUN/conj	Reverse
bodied/ADJ/amod<_X/NOUN/attr_<with/ADP/prep_<Y/NOUN/pobj	Forward
X/NOUN/attr_<affiliate/VERB/acl_<with/ADP/prep_<Y/PROPN/pobj	Forward
X/PROPN/compound>_paper/PROPN/compound>_princess/PROPN/ROOT_<Y/PROPN/compound	Reverse
X/PROPN/compound>_eagle/PROPN/compound>_owl/PROPN/ROOT_<Y/PROPN/conj	Reverse
large/ADJ/amod<_X/NOUN/attr_<with/ADP/prep_<Y/NOUN/pobj	Forward
steelhead/VERB/amod<_X/NOUN/conj_<Y/NOUN/conj	Forward
lead/NOUN/compound<_X/NOUN/appos_<Y/NOUN/conj	Forward
X/NOUN/compound>_cat/NOUN/compound>_Y/NOUN/ROOT	Forward
alto/NOUN/compound<_X/NOUN/dobj_<Y/NOUN/conj	Reverse
X/NOUN/nsubj>_building/NOUN/nsubj>_house/VERB/ROOT_<Y/NOUN/dobj	Reverse
X/PROPN/compound>_elm/PROPN/compound>_beetle/PROPN/ROOT_<Y/PROPN/compound	Forward
coastal/ADJ/amod<_X/NOUN/nsubj_<Y/NOUN/conj	Forward
cutthroat/NOUN/amod<_X/NOUN/nsubj_<Y/NOUN/conj	Forward
either/CCONJ/preconj<_X/PROPN/pobj_<Y/NOUN/conj	Reverse
response/PROPN/compound<_X/PROPN/pobj_<Y/NOUN/conj	Reverse
X/PROPN/dobj_<shearwater/NOUN/conj_<Y/PROPN/conj	Forward
little/PROPN/compound<_X/PROPN/dobj_<shearwater/NOUN/conj_<Y/PROPN/conj	Forward
X/PROPN/dobj_<shearwater/NOUN/conj_<Y/PROPN/conj_>oystercatcher/PROPN/conj	Forward
medical/PROPN/compound<_X/PROPN/pobj_<at/ADP/prep_<Y/PROPN/pobj	Reverse
X/NOUN/compound>_charge/NOUN/compound>_projectile/NOUN/ROOT_<Y/NOUN/appos	Reverse
chinook/PROPN/compound<_X/NOUN/pobj_<Y/NOUN/conj	Reverse
weather/NOUN/compound<_X/NOUN/conj_<Y/NOUN/conj	Forward
game/NOUN/compound<_X/NOUN/pobj_<Y/NOUN/appos	Reverse
X/PROPN/attr_<shearwater/NOUN/conj_<Y/PROPN/conj	Forward
little/PROPN/compound<_X/PROPN/attr_<shearwater/NOUN/conj_<Y/PROPN/conj	Forward
three/NUM/nummod<_X/NOUN/conj_<Y/NOUN/appos	Forward
the/DET/det<_X/PROPN/nmod_<of/ADP/prep_<Y/PROPN/pobj	Reverse
coastal/ADJ/amod<_X/NOUN/conj_<Y/NOUN/conj	Forward
three/NUM/nummod<_X/NOUN/appos_<Y/NOUN/appos	Forward
X/PROPN/appos_<Y/PROPN/npadvmod	Reverse
X/PROPN/conj_<park/PROPN/conj_<gardens/PROPN/conj_<Y/PROPN/conj	Reverse
chinook/NOUN/compound<_X/NOUN/nsubj_<Y/NOUN/conj	Reverse
little/PROPN/compound<_X/PROPN/attr_<Y/PROPN/conj	Forward
X/PROPN/attr_<shearwater/NOUN/conj_<petrel/PROPN/conj_<Y/PROPN/conj	Forward
X/PROPN/attr_<Y/PROPN/conj_>gull/PROPN/conj	Forward
X/PROPN/attr_<gull/PROPN/conj_<Y/PROPN/conj	Forward
little/PROPN/compound<_X/PROPN/attr_<gull/PROPN/conj_<Y/PROPN/conj	Forward
X/PROPN/attr_<gull/PROPN/conj_<Y/PROPN/conj_>oystercatcher/PROPN/conj	Forward
X/PROPN/attr_<Y/PROPN/conj_>oystercatcher/PROPN/conj	Forward
X/PROPN/attr_<petrel/PROPN/conj_<Y/PROPN/conj	Forward
little/PROPN/compound<_X/PROPN/attr_<petrel/PROPN/conj_<Y/PROPN/conj	Forward
sloth/ADJ/amod<_X/NOUN/dobj_<Y/NOUN/conj	Reverse
X/PROPN/dobj_<petrel/PROPN/conj_<Y/PROPN/conj	Forward
little/PROPN/compound<_X/PROPN/dobj_<petrel/PROPN/conj_<Y/PROPN/conj	Forward
X/PROPN/dobj_<shearwater/NOUN/conj_<Y/PROPN/conj_>gull/PROPN/conj	Forward
X/PROPN/dobj_<shearwater/NOUN/conj_<gull/PROPN/conj_<Y/PROPN/conj	Forward
X/PROPN/dobj_<shearwater/NOUN/conj_<petrel/PROPN/conj_<Y/PROPN/conj	Forward
class/NOUN/compound<_X/NOUN/attr_<with/ADP/prep_<Y/NOUN/pobj	Forward
screw/NOUN/compound<_X/NOUN/attr_<with/ADP/prep_<Y/NOUN/pobj	Forward
sloop/NOUN/nmod<_X/NOUN/attr_<with/ADP/prep_<Y/NOUN/pobj	Forward
X/PROPN/poss>_rail/PROPN/poss>_Y/NOUN/ROOT	Reverse
via/PROPN/compound<_X/PROPN/poss>_rail/PROPN/poss>_Y/NOUN/ROOT	Reverse
little/PROPN/compound<_X/PROPN/dobj_<Y/PROPN/conj	Forward
gopher/NOUN/amod<_X/NOUN/conj_<Y/NOUN/conj	Reverse
X/PROPN/dobj_<Y/PROPN/conj_>oystercatcher/PROPN/conj	Forward
X/NOUN/attr_<build/VERB/acl_<by/ADP/agent_<Y/PROPN/pobj	Forward
X/PROPN/compound>_air/PROPN/compound>_unit/PROPN/ROOT_<Y/PROPN/compound	Reverse
X/PROPN/nmod_<Y/PROPN/npadvmod	Reverse
X/PROPN/compound>_floor/PROPN/compound>_Y/NOUN/ROOT	Reverse
